UPS Global Home 

                          Select your location United States - English Albania 
                          - English Algeria - English American Samoa - English 
                          Angola - English Anguilla - English Antigua - English 
                          Argentina - Spanish Argentina - English Armenia - 
                          English Aruba - English Australia - English Austria - 
                          German Austria - English Azerbaijan - English Bahamas 
                          - English Bahrain - English Bangladesh - English 
                          Barbados - English Belarus - English Belgium - English 
                          Belgium - French Belgium - Dutch Belize - English 
                          Benin - English Bermuda - English Bhutan - English 
                          Bolivia - English Bonaire - English Bosnia Herzegovina 
                          - English Botswana - English Brazil - Portuguese 
                          Brazil - English British Virgin Islands - English 
                          Brunei - English Bulgaria - English Burkina Faso - 
                          English Burundi - English Cambodia - English Cameroon 
                          - English Canada - English Canada - French Cape Verde 
                          - English Cayman Islands - English Chad - English 
                          Chile - Spanish Chile - English China - Chinese China 
                          - English Colombia - English Congo - English Cook 
                          Islands - English Costa Rica - Spanish Costa Rica - 
                          English Croatia - English Curacao - English Cyprus - 
                          English Czech Republic - English Denmark - Danish 
                          Denmark - English Djibouti - English Dominica - 
                          English Dominican Republic - Spanish Dominican 
                          Republic - English Ecuador - English Egypt - English 
                          El Salvador - English Estonia - English Ethiopia - 
                          English Fiji - English Finland - English France - 
                          French France - English French Guiana - English French 
                          Polynesia - English Gabon - English Gambia - English 
                          Georgia - English Germany - German Germany - English 
                          Ghana - English Gibraltar - English Greece - English 
                          Grenada - English Guadeloupe - English Guam - English 
                          Guatemala - Spanish Guatemala - English Guinea - 
                          English Guinea Bissau - English Guyana - English Haiti 
                          - English Honduras - English Hong Kong - Chinese Hong 
                          Kong - English Hungary - English Iceland - English 
                          India - English Indonesia - English Ireland (Republic 
                          of) - English Israel - English Italy - Italian Italy - 
                          English Ivory Coast - English Jamaica - English Japan 
                          - Japanese Japan - English Jordan - English Kazakhstan 
                          - English Kenya - English Kiribati - English Kosovo - 
                          English Kosrae Island - English Kuwait - English 
                          Kyrgyzstan - English Laos - English Latvia - English 
                          Lebanon - English Lesotho - English Liberia - English 
                          Libya - English Lithuania - English Luxembourg - 
                          English Macau - English Macedonia (FYROM) - English 
                          Madagascar - English Malawi - English Malaysia - 
                          English Maldives - English Mali - English Malta - 
                          English Marshall Islands - English Martinique - 
                          English Mauritania - English Mauritius - English 
                          Mexico - Spanish Mexico - English Moldova - English 
                          Mongolia - English Montserrat - English Morocco - 
                          English Mozambique - English Nepal - English 
                          Netherlands - Dutch Netherlands - English New 
                          Caledonia - English New Zealand - English Nicaragua - 
                          English Niger - English Nigeria - English Northern 
                          Mariana Islands - English Norway - English Oman - 
                          English Pakistan - English Palau - English Panama - 
                          Spanish Panama - English Papua New Guinea - English 
                          Paraguay - English Peru - English Philippines - 
                          English Poland - English Ponape - English Portugal - 
                          Portuguese Portugal - English Puerto Rico - Spanish 
                          Puerto Rico - English Qatar - English Reunion - 
                          English Romania - English Rota - English Russia - 
                          English Rwanda - English Saipan - English Saudi Arabia 
                          - English Senegal - English Serbia and Montenegro - 
                          English Seychelles - English Singapore - English 
                          Slovakia - English Slovenia - English Solomon Islands 
                          - English South Africa - English South Korea - Korean 
                          South Korea - English Spain - Spanish Spain - English 
                          Sri Lanka - English St. Barthelemy - English St. Croix 
                          - English St. Eustatius - English St. John - English 
                          St. Kitts and Nevis - English St. Lucia - English St. 
                          Maarten - English St. Thomas - English St. Vincent and 
                          the Grenadines - English Suriname - English Swaziland 
                          - English Sweden - Swedish Sweden - English 
                          Switzerland - English Switzerland - German Switzerland 
                          - French Syria - English Tadjikistan - English Taiwan 
                          - Chinese Taiwan - English Tanzania - English Thailand 
                          - English Tinian - English Togo - English Tonga - 
                          English Tortola - English Trinidad and Tobago - 
                          English Truk - English Tunisia - English Turkey - 
                          English Turkmenistan - English Turks and Caicos - 
                          English Tuvalu - English US Virgin Islands - English 
                          Uganda - English Ukraine - English Union Island - 
                          English United Arab Emirates - English United Kingdom 
                          - English United States - English Uruguay - English 
                          Uzbekistan - English Vanuatu - English Venezuela - 
                          English Vietnam - English Virgin Gorda - English 
                          Wallis and Futuna - English Western Samoa - English 
                          Yap - English Yemen - English Zambia - English 
                          Zimbabwe - English 


                         Remember this location.










                  Copyright © 1994-2006 United Parcel Service of America, Inc. 
                  All rights reserved. 
                  Web Site Terms of Use  | Privacy Policy 



